NO ./textures/north.xpm
SO ./textures/south.xpm
WE ./textures/west.xpm
EA ./textures/east.xpm

F 300,100,0
C 225,3,100
1111111111111111111111
1000000000000000000001
1010000010000000000001
1000000000000000000001
1000000000000000000001
1000000000000000000001
100000000000000000000111111111
100000000000000000000000000001
11000000000000000000N000010001
100000000000000000000000010001
100000000000000000000000000001
11000001110101011111011110001
11110111 1110101 101111010001
11111111 1111111 111111111111
