NO ./textures/north.xpm
SO ./textures/south.xpm
WE ./textures/west.xpm
EA ./textures/east.xpm

F 200,150,20
C 30,5,255


        1111111111111111111111111
        1100000100110000000000001
        101100010111000000W000001
        1001010000000000000000001
111111111011000001110010000000001
100000010011000011110011111111111
1111011 111111011100000110001
11101111111111111010100100001
10000011111111110000000100001
11111111111111111111111111111
10000000000000001100000100001
10000000000000000101010000001
11000001010101010111011110001
11110111011101010101111010001
111111111111111111111 1111111
